NO ./images/bouno2.png
SO ./images/bouno2.png
WE ./images/bouno2.png

F 0,150,0
C 0,0,255
EA ./images/bouno2.png

11111111
1S000001
10000001
100E0001
10000001
10000001
11111111
