NO ./images/zalij1.png
SO ./images/zalij2.png
WE ./images/zalij1.png
EA ./images/zalij2.png

F 0,150,0
C 0,0,0

        1111111111111111111111111
        100000000000S000000000001
        1000000000000000000000001
        1000000000000000000000001
111111111111111111111001111111111
100000000000100000000000000000001
100000000000100000000111111111111
100000000000100000000100000000001
100111111111100000000100000000001
100000000000100000000000000000001
100000000000100000000000000000001
100000000000100000000100000000001
100000000000000000000100000000001
100000000000100000000111111111111
100000000000100000000100000000001
100000000000100000000100000000001
111111111111100000000100000000001
100000000000000000000100000000001
100000000000000000000000000000001
111111111111111101111111111111111
11111111111110000011111111111
11110111111101011101010000001
11000000110101011100000010001
10000000000000001100000010001
10000000000000000000000010001
11111111101010111111001111101
11111111 11100000000111111101
11111111 11111111101111111101
11111111 11111111110000000001
11111111 11111111111111111111