111111111111111
1E1C0000C0000C1
1CCCCCCCCCCP001
1C0001111111111
101111CCCCCCCC1
1CCCC1111111101
1001CCCCCCCCCC1
1CCCCCCCCCCCCC1
111111111111111