111111111111111
100C0000C0000P1
100C0000C001001
100C0000C000001
1E0C0010C000001
111111111111111